1011111111111111111
1000010000100000001
1011010110101111101
1010010010101010001
1011111010000010111
1001001011110110101
1101011000011110101
1000010001001000001
1011110101111011111
1000000100010000001
1111111111111110111

